fbbbbbbbbbbbbbbg
eOOOOOOOOOOOOOOc
ePPPPPPPPPPPPPPc
e33333333333333c
e33333333333333c
e33333333333333c
e33333333333333c
e33333333333333c
e33333333333333c
e33333333333333c
e33333333333333c
e33333333333333c
e33333333333333c
e33333333333333c
e33333333333333c
iddddddddddddddh
