fbbbbbbbbbbbbbbg
eIIIIIIIIIIIIIIc
eHHHHHHHHHHHHHHc
e22222222222222c
e22222222222222c
e22222222222222c
e22222222222222c
e22222222222222c
e22222222222222c
e22222222222222c
e22222222222222c
e22222222222222c
e22222222222222c
e22222222222222c
e22222222222222c
iddddddddddddddh
