fbbbbbbbbbbbbbbg
eDDDDDDDDDDDDDDc
eEEEEEEEEEEEEEEc
e00000000000000c
e00000000000000c
e00000000000000c
e00000000000000c
e00000000000000c
e00000000000000c
e00000000000000c
e00000000000000c
e00000000000000c
e00000000000000c
e00000000000000c
e00000000000000c
iddddddddddddddh