aae544444555555c
fbk544444555555c
eFF54444455mdddh
eGG54444455lbbbg
e5554444455FFFFc
e5444444455GGGGc
e54444444444445c
e54444444444445c
e54444444444445c
e54444444444445c
e54444444444445c
e54444444444445c
e54444444444445c
e54444444444445c
e55555555555555c
iddddddddddddddh