fbbbbbbbbbbbbgaa
eFFFFFFFFFFFFcaa
eGGGGGGGGGGGGcaa
e555555555555FFF
e555555555555GGG
e544444444445555
e544444444445555
e544444444445555
e544444444445mdd
e544444444445lbg
e544444444445FFc
e544444445555GGc
e54444444555555c
e54444444555555c
e55544444555555c
idj544444555555c