fbbbbbbtbbbbbbbg
eKKKKKKoIIIIIIIc
eLLLLLLoJJJJJJJc
e666666o2222222c
e666666o2222222c
e666666o2222222c
e666666o2222222c
e666666o2222222c
e666666o222mdddh
e666666r222lbbbg
e666666K222KKKKc
e666666L222LLLLc
e66666666666666c
e66666666666666c
e66666666666666c
iddddddddddddddh