fbbbbbbbbbbbbbbg
eIIIIIIIIIIIIIIc
eJJJJJJJJJJJJJJc
e22222222222222c
e22222222222222c
e22222222222222c
e22222222222222c
idddddj222mddddh
fbbbbbk222lbbbbg
eDDDDDD222DDDDDc
eEEEEEE222EEEEEc
e22222222222222c
e22222222222222c
e22222222222222c
e22222222222222c
iddddddddddddddh
