fbbbbbtbbbbbbbbg
eKKKKKoKKKKKKKKc
eLLLLLoLLLLLLLLc
e66666o66666666c
e66666o66666666c
e66666o66666666c
e66666o66666666c
e66666o66666666c
e66666o66666666c
e66666r66666666c
e66666K66666666c
e66666L66666666c
e66666666mdddddh
e66666666caaaaaa
e66666666caaaaaa
iddddddddhaaaaaa